000000000000000000000000000000000000000000000000000
000000000000000000000000000000000000000000000000000
000000000000000000000000000000000000000000000000000
000000000000000000000000000000000000000000000000000
000000000000000000000000000000000000000000000000000
000000000000000000000000000000000000000000000000000
000000000000000000000000000000000000000000000000000
000000000000000000000000000000000000000000000000000
000000000000000000000000000000000000000000000000000
000000000000000000000000000000000000000000000000000
000000000000000000000000000000000000000000000000000
222222222222222222222222222222000022222222222222222
111111111111111111111111111111000011111111111111111
111111111111111111111111111110000111111111111111111
111111111111111111111111111000000111111111111111111
111111111111111111111111111111000111111111111111111
111111111111111111111111111111000111111111111111111
111111111111111111111111111111000111111111111111111
111111111111111111111111111111000111111111111111111
111111111111111111111111111111111111111111111111111
111111111111111111111111111111111111111111111111111
111111111111111111111111111111111111111111111111111
111111111111111111111111111111111111111111111111111
111111111111111111111111111111111111111111111111111




